"filename", "language", "JSON", "JavaScript", "Markdown", "HTML", "XML", "comment", "blank", "total"
"/Users/coltonshaw/Library/Mobile Documents/com~apple~CloudDocs/Scripts/Metrics for Ministry - Prod/.clasp.json", "JSON", 1, 0, 0, 0, 0, 0, 1, 2
"/Users/coltonshaw/Library/Mobile Documents/com~apple~CloudDocs/Scripts/Metrics for Ministry - Prod/README.md", "Markdown", 0, 0, 24, 0, 0, 0, 7, 31
"/Users/coltonshaw/Library/Mobile Documents/com~apple~CloudDocs/Scripts/Metrics for Ministry - Prod/changelog.md", "Markdown", 0, 0, 43, 0, 0, 0, 18, 61
"/Users/coltonshaw/Library/Mobile Documents/com~apple~CloudDocs/Scripts/Metrics for Ministry - Prod/helperData/createTestPeople.js", "JavaScript", 0, 175, 0, 0, 0, 12, 54, 241
"/Users/coltonshaw/Library/Mobile Documents/com~apple~CloudDocs/Scripts/Metrics for Ministry - Prod/src/appsscript.json", "JSON", 56, 0, 0, 0, 0, 0, 0, 56
"/Users/coltonshaw/Library/Mobile Documents/com~apple~CloudDocs/Scripts/Metrics for Ministry - Prod/src/assets/Savvy Tool Belt_Icon_on Light.svg", "XML", 0, 0, 0, 0, 34, 1, 2, 37
"/Users/coltonshaw/Library/Mobile Documents/com~apple~CloudDocs/Scripts/Metrics for Ministry - Prod/src/assets/backButtonSVG.html", "HTML", 0, 0, 0, 9, 0, 0, 1, 10
"/Users/coltonshaw/Library/Mobile Documents/com~apple~CloudDocs/Scripts/Metrics for Ministry - Prod/src/assets/documentIcon.html", "HTML", 0, 0, 0, 70, 0, 1, 2, 73
"/Users/coltonshaw/Library/Mobile Documents/com~apple~CloudDocs/Scripts/Metrics for Ministry - Prod/src/assets/gdsConnectorSVG.html", "HTML", 0, 0, 0, 9, 0, 0, 0, 9
"/Users/coltonshaw/Library/Mobile Documents/com~apple~CloudDocs/Scripts/Metrics for Ministry - Prod/src/assets/infoIcon.html", "HTML", 0, 0, 0, 10, 0, 0, 0, 10
"/Users/coltonshaw/Library/Mobile Documents/com~apple~CloudDocs/Scripts/Metrics for Ministry - Prod/src/assets/jar.html", "HTML", 0, 0, 0, 22, 0, 1, 2, 25
"/Users/coltonshaw/Library/Mobile Documents/com~apple~CloudDocs/Scripts/Metrics for Ministry - Prod/src/assets/learnMore.html", "HTML", 0, 0, 0, 38, 0, 0, 0, 38
"/Users/coltonshaw/Library/Mobile Documents/com~apple~CloudDocs/Scripts/Metrics for Ministry - Prod/src/assets/logoutIcon.html", "HTML", 0, 0, 0, 20, 0, 0, 1, 21
"/Users/coltonshaw/Library/Mobile Documents/com~apple~CloudDocs/Scripts/Metrics for Ministry - Prod/src/assets/refreshIcon.html", "HTML", 0, 0, 0, 20, 0, 0, 1, 21
"/Users/coltonshaw/Library/Mobile Documents/com~apple~CloudDocs/Scripts/Metrics for Ministry - Prod/src/assets/refreshIconSettings.html", "HTML", 0, 0, 0, 21, 0, 0, 1, 22
"/Users/coltonshaw/Library/Mobile Documents/com~apple~CloudDocs/Scripts/Metrics for Ministry - Prod/src/assets/settingsIcon.html", "HTML", 0, 0, 0, 7, 0, 0, 0, 7
"/Users/coltonshaw/Library/Mobile Documents/com~apple~CloudDocs/Scripts/Metrics for Ministry - Prod/src/classes/list.js", "JavaScript", 0, 54, 0, 0, 0, 10, 11, 75
"/Users/coltonshaw/Library/Mobile Documents/com~apple~CloudDocs/Scripts/Metrics for Ministry - Prod/src/error.js", "JavaScript", 0, 10, 0, 0, 0, 5, 1, 16
"/Users/coltonshaw/Library/Mobile Documents/com~apple~CloudDocs/Scripts/Metrics for Ministry - Prod/src/gdsAddOn/authorization.js", "JavaScript", 0, 54, 0, 0, 0, 34, 20, 108
"/Users/coltonshaw/Library/Mobile Documents/com~apple~CloudDocs/Scripts/Metrics for Ministry - Prod/src/gdsAddOn/config.js", "JavaScript", 0, 87, 0, 0, 0, 7, 37, 131
"/Users/coltonshaw/Library/Mobile Documents/com~apple~CloudDocs/Scripts/Metrics for Ministry - Prod/src/gdsAddOn/getData.js", "JavaScript", 0, 196, 0, 0, 0, 45, 84, 325
"/Users/coltonshaw/Library/Mobile Documents/com~apple~CloudDocs/Scripts/Metrics for Ministry - Prod/src/gdsAddOn/getSchema.js", "JavaScript", 0, 284, 0, 0, 0, 1, 78, 363
"/Users/coltonshaw/Library/Mobile Documents/com~apple~CloudDocs/Scripts/Metrics for Ministry - Prod/src/globalFunctions.js", "JavaScript", 0, 15, 0, 0, 0, 2, 8, 25
"/Users/coltonshaw/Library/Mobile Documents/com~apple~CloudDocs/Scripts/Metrics for Ministry - Prod/src/logging.js", "JavaScript", 0, 18, 0, 0, 0, 0, 3, 21
"/Users/coltonshaw/Library/Mobile Documents/com~apple~CloudDocs/Scripts/Metrics for Ministry - Prod/src/pcoApiCalls.js", "JavaScript", 0, 82, 0, 0, 0, 95, 56, 233
"/Users/coltonshaw/Library/Mobile Documents/com~apple~CloudDocs/Scripts/Metrics for Ministry - Prod/src/sheetsAddOn/Pco_CheckinsModule.js", "JavaScript", 0, 151, 0, 0, 0, 44, 68, 263
"/Users/coltonshaw/Library/Mobile Documents/com~apple~CloudDocs/Scripts/Metrics for Ministry - Prod/src/sheetsAddOn/Pco_GivingModule.js", "JavaScript", 0, 111, 0, 0, 0, 30, 57, 198
"/Users/coltonshaw/Library/Mobile Documents/com~apple~CloudDocs/Scripts/Metrics for Ministry - Prod/src/sheetsAddOn/Pco_OrganizationData.js", "JavaScript", 0, 13, 0, 0, 0, 1, 13, 27
"/Users/coltonshaw/Library/Mobile Documents/com~apple~CloudDocs/Scripts/Metrics for Ministry - Prod/src/sheetsAddOn/Pco_PeopleModule.js", "JavaScript", 0, 155, 0, 0, 0, 29, 61, 245
"/Users/coltonshaw/Library/Mobile Documents/com~apple~CloudDocs/Scripts/Metrics for Ministry - Prod/src/sheetsAddOn/calculate_total_storage.js", "JavaScript", 0, 16, 0, 0, 0, 1, 17, 34
"/Users/coltonshaw/Library/Mobile Documents/com~apple~CloudDocs/Scripts/Metrics for Ministry - Prod/src/sheetsAddOn/dialog.html", "HTML", 0, 0, 0, 14, 0, 0, 2, 16
"/Users/coltonshaw/Library/Mobile Documents/com~apple~CloudDocs/Scripts/Metrics for Ministry - Prod/src/sheetsAddOn/menu.js", "JavaScript", 0, 72, 0, 0, 0, 9, 25, 106
"/Users/coltonshaw/Library/Mobile Documents/com~apple~CloudDocs/Scripts/Metrics for Ministry - Prod/src/sheetsAddOn/sidebar-javascript.html", "HTML", 0, 0, 0, 128, 0, 0, 57, 185
"/Users/coltonshaw/Library/Mobile Documents/com~apple~CloudDocs/Scripts/Metrics for Ministry - Prod/src/sheetsAddOn/sidebar-stylesheet.html", "HTML", 0, 0, 0, 216, 0, 0, 48, 264
"/Users/coltonshaw/Library/Mobile Documents/com~apple~CloudDocs/Scripts/Metrics for Ministry - Prod/src/sheetsAddOn/sidebar.html", "HTML", 0, 0, 0, 219, 0, 14, 29, 262
"/Users/coltonshaw/Library/Mobile Documents/com~apple~CloudDocs/Scripts/Metrics for Ministry - Prod/src/sheetsAddOn/signin-failure.html", "HTML", 0, 0, 0, 279, 0, 2, 54, 335
"/Users/coltonshaw/Library/Mobile Documents/com~apple~CloudDocs/Scripts/Metrics for Ministry - Prod/src/sheetsAddOn/signin-success.html", "HTML", 0, 0, 0, 278, 0, 2, 54, 334
"/Users/coltonshaw/Library/Mobile Documents/com~apple~CloudDocs/Scripts/Metrics for Ministry - Prod/src/sheetsAddOn/spreadsheetFunctions.js", "JavaScript", 0, 202, 0, 0, 0, 65, 90, 357
"/Users/coltonshaw/Library/Mobile Documents/com~apple~CloudDocs/Scripts/Metrics for Ministry - Prod/src/syncSettings.js", "JavaScript", 0, 141, 0, 0, 0, 7, 53, 201
"/Users/coltonshaw/Library/Mobile Documents/com~apple~CloudDocs/Scripts/Metrics for Ministry - Prod/src/updateScripts.js", "JavaScript", 0, 51, 0, 0, 0, 5, 22, 78
"/Users/coltonshaw/Library/Mobile Documents/com~apple~CloudDocs/Scripts/Metrics for Ministry - Prod/src/userProperties.js", "JavaScript", 0, 483, 0, 0, 0, 95, 54, 632
"Total", "-", 57, 2370, 67, 1360, 34, 518, 1092, 5498